1111111111111111111
1C000000C0000001111
10010111110000011C1
10010000C0011001101
1001000000000000101
10001111101100001C1
1P011E00000C0011101
1000000000000000001
10011111111000000C1
10000000C000C000111
1001C00000000001111
1111111111111111111