1111111111111
10000000C0001
1E01011111001
10010000C0001
1001000000001
1000111110111
1P011E00000C1
1111111111111